1,2,0,0,None
4,3,0,0,None
5,4,0,0,None
2,4,0,2,-1,0,-1
3,5,0,2,-1,0,-1
6,6,0,3,None
7,6,0,3,None
8,6,0,3,None
9,6,0,3,None
10,6,0,3,None
